###############################
#~~#~~~~~~~~~~#~~~~~##~#~~~~~~#
#~##~###~###~####~#~~#~#~#~##~#
#~~##~~#~##~~~#~#~##~~~#~~~#~~#
##~~##~#~~~~#~~~~~###~##~###~##
#~#~#~~~~#~~#~###~~#~~#~~#~#~~#
#~#~~#~########~#####~~~~#~##~#
#~#~~~~~~~~##+~~~~~#####~~~##~#
#~~~##~###~~##~#~###~~~###~#~~#
#~#~#~~~~~~~~~~~~~~~~#~~~#~#$~#
###############################
